#########################
# ^ #                   #
#   #                   #
# ! #                   #
#   #                   #
#                       #
#                       #
#  ###                  #
#  ###                  #
#                       #
#                       #
#                       #
########                #
#     ##                #
#     ##                #
# !#####                #
#                       #
#                       #
#                       #
#                   #####
#               #       #
#               #!      #
#               #    !  #
#               #       #
#########################